1111111111111
10000000000P1
1010000000001
1000001000001
100000C000001
1010000001001
1000000111111
1E00000010001
1111111111111
