111111111111111111111111111111
100000000000000000000000000001
101111111111111111111111111001
101000000000000000000000001001
101011111111111111111111101001
101010000000000000000000101001
101010111111111111111110101001
1010101C0000000000000000101001
101010111111111111111111101001
101010000000000000000000001001
101011111111111111111111111001
101000000000000000000000000001
101111111111111111111111111111
10000000000000000000000000EP01
100000000000000000000000000001
111111111111111111111111111111