11111111111111111111111111111
100000C000000100CCC0000000001
111110C0001111010011000000111
1000000C000001000000111111101
11100011111111001100000000001
10101000001001000001111111101
111000CCCC0001001100000000001
100000C0000001000000000000001
100000C0000001000111111111111
100111100C0000000C0C000000001
1000000C00111100C011111111111
1000000C0000000C0000000000001
1000000C00111100C000000000001
1P00000C0000000C01E1000000001
11111111111111111111111111111