11111111111111111111111111111
100000C0000P00000000000C00001
10100000000000000000000000001
100C00100000C00000000000C0001
100000C0000000000111000000001
10100000010000000000000000001
1000000111110000001110000C001
10000001111100000000000000001
100000011111000000C0000100001
100C000111110000C000000000001
10000001111100000000111100001
10000001111100000000000000001
10000001111100000011100000001
1E00000C10000000000000C000001
11111111111111111111111111111